asd
11111111
1000CE01
1P000001
11111111
